,,k1,k1,,
,t1,,,t1,
k1,,,,,k1
k1,,,,,k1
,t1,,,t1,
,,k1,k1,,
