,,k2,k2,,
,k2,,,k2,
k2,,,,,k2
k2,,,,,k2
,k2,,,k2,
,,k2,k2,,f1
